###########
#@  ~  $ .#
#  F      #
#  $   .  #
#  K C  M #
###########
