########
#      #
# .  . #
#      #
# $  $ #
#  @   #
########