###########
#@        #
#  .  .   #
#  ~  ~   #
#  ~  ~   #
#  $  $   #
#         #
###########