#########
#@      #
# $M.   #
#  KC   #
#########