#########
#       #
# .@. . #
#       #
# $   $ #
#   $   #
#       #
#########