###########
#         #
# F # F   #
# . # . F #
#   @   . #
###########